_________________________________________
_________________________________________
_________________________________________
_________________________________________
_________________________________________
_________________________________________
_________________________________________
_________________________________________
_________________________________________
_________________________________________
_________________________________________
_________________________________________
_________________________________________
_________________________________________
_________________________________________
_________________________________________
_________________________________________
_________________________________________
_________________________________________
___________XXXX___________XXXX___________
___________XXXXXXXXX_XXXXXXXXX___________
___________XXXXXXXXXXXXXXXXXXX___________
___________XXXXXXXXXXXXXXXXXXX___________
___________XXXXXXXXXXXXXXXXXXX___________
____________XXXXXXXXXXXXXXXXX____________
____________XXXXXXXXXXXXXXXXX____________
_____________XXXXXXXXXXXXXXX_____________
______________XXXXXXXXXXXXX______________
_______________XXXXXXXXXXX_______________
________________XXXXXXXXX________________
_________________________________________
_________________________________________
_________________________________________
_________________________________________
_________________________________________
_________________________________________
_________________________________________
_________________________________________
_________________________________________
_________________________________________
_________________________________________