_________________________________________
_________________________________________
_________________________________________
_________________________________________
_________________________________________
_________________________________________
_________________________________________
_________________________________________
_________________________________________
_________________________________________
_________________________________________
_________________________________________
_________________________________________
_________________________________________
_________________________________________
_________________________________________
_________________________________________
_________________________________________
_________________________________________
_________..:;;!___________!;;:.._________
_________..:;;!|XXXX_XXXX|!;;:.._________
_________..:;;!|XXXXXXXXX|!;;:.._________
_________..::;!|XXXXXXXXX|!;::.._________
_________..::;!!|XXXXXXX|!!;::.._________
_________...:;;!||XXXXX||!;;:..._________
__________..::;;!!|||||!!;;::..__________
__________...::;;!!!!!!!;;::...__________
___________...::;;;;;;;;;::...___________
____________...::::;;;::::...____________
_____________...:::::::::..._____________
______________.............______________
________________.........________________
_________________________________________
_________________________________________
_________________________________________
_________________________________________
_________________________________________
_________________________________________
_________________________________________
_________________________________________
_________________________________________