_________________________________________
_________________________________________
_________________________________________
_________________________________________
_________________________________________
_________________________________________
_________________________________________
_________________________________________
_________________________________________
_________________________________________
_________________________________________
_________________________________________
_________________________________________
_________________________________________
_________________________________________
_XXXXXXXXXXXXXXXXXXXXXXXXXXX_____________
__XXXXXXXXXXXXXXXXXXXXXXXXXXXXXXXXXXXXXXX
___XXXXXXXXXXXXXXXXXXXXXXXXXXXXXXXXXXXXXX
____XXXXXXXXXXXXXXXXXXXXXXXXXXXXXXXXXXXXX
_____XXXXXXXXXXXXXXXXXXXXXXXXXXXXXXXXXXXX
______XXXXXXXXXXXXXXXXXXXXXXXXXXXXXXXXXXX
_______XXXXXXXXXXXXXXXXXXXXXXXXXXXXXXXXXX
________XXXXXXXXXXXXXXXXXXXXXXXXXXXXXXXXX
_________XXXXXXXXXXXXXXXXXXXXXXXXXXXXXXXX
_________________________________________
_________________________________________
_________________________________________
_________________________________________
_________________________________________